###############################
#    ** **    *   3           #
# # # #*# # # # # # # # # # # #
#p     **l* *  *   * b*   *   #
# # # # # #*# # # # # # #*# # #
#*   *s*    *** *   **   1    #
# # # # # # # # # # # # # #*# #
#   *a     *   4    *    **   #
# #*# # #*#*#*#*# # # # # #*# #
#   2    *   * *    *   *     #
#*# # # # # # #  ## # #*# # #*#
# *    *o** 4  **d***    2    #
###############################