###############################
#  * *2       *  ** * *   3  *#
# # # # #*# # #*# # # # # #*# #
#    * * *** **      *    **  #
# #*# # # # #1# #b#1# # # # #*#
#    p     *     **      *  **#
# # #*# # # # # #*#*#*#*# # # #
#   *        *   * *x* 3   *  #
# # # # #*# # # # # # #*# #*# #
#   ****         *1           #
# # # # # # # # # #*# # # # #*#
#  ** *   *    2         1    #
###############################